000000000000000
001201110000000
001100111110000
000100000011110
000111100000010
000100000001110
011101110000010
000101100110000
000000001110000
001000000000100
001000011110000
001111000010100
000001111000100
000001000001100
111000000001000
010000011100010
000100000001000
001100111000000
001000001001000
001000001001000
000011100011000
011000100111100
011100100001000
000000000001000
000111110000000
000100000000100
000001111101100
000011300001100
001110000011100
000000000000000
000000000000000