000000000000000
000000000000000
000000000000000
000000000000000
000001000010000
000010000000000
000100000000000
000000000001000
000000000010000
000000000100000
000000000000100
001000000000000
000000001000000
000000000000010
000000000001000
000100000000000
010000000000010
000003000000000
000000000000000
001200000100000
000000000000000
000000000000000
000001000000000
000000000000000
000100001000000
000000000000100
000000000000000
000001000000000
000000000000000
000000000000000
000000000000000